................
................
####........####
................
................
......####......
................
................
..####....####..
................
@...............
################