................................
................................
................................
................................
...............##...............
..###......................###..
................................
................................
....##......########......##....
................................
.......!...............!........
......####............####......
................................
................................
...........!........!...........
..........#####..#####..........
................................
................................
......@.........................
......####################......
................................
................................
................................
................................